NO textures/wolfenstein/grey_stone.xpm
SO textures/wolfenstein/purple_stone.xpm
WE textures/wolfenstein/red_brick.xpm
EA textures/wolfenstein/wood.xpm

F 220,100,0
C 225,30,0




111111111111111111111
1000000000110000000001
1011000001110000000011
10010000000000000000001
11111111101100000111001
10000000001100000111011   101
1111011111111101110001
1111111101101111111111
1                1
1                    
11111111111111111111111
11000000110101011100001    1001
000000000000N0001100001
10000000000000001101001
11000001110101011111011
1101011 1110101 101111
111111 1111111 11111111